1.412162862453531620e+00	-5.398203549020208492e-03	6.757885639126542943e-01
1.412162862453531620e+00	3.362263413238975041e-03	7.180295780189409616e-01
1.412162862453531620e+00	-3.325196191248569466e-02	7.154702357582976013e-01
1.412162862453531620e+00	-2.814974661096031339e-02	7.332291219015836248e-01
1.412162862453531620e+00	-1.202540845697053218e-02	7.474923491593318259e-01
1.412162862453531620e+00	9.518513673513639972e-03	7.371084442702653394e-01
1.412162862453531620e+00	2.708451622449559171e-02	7.450482502115225447e-01
1.412162862453531620e+00	-2.907887554869037494e-02	7.606054840279952156e-01
1.412162862453531620e+00	8.618505146743449252e-03	7.731882977526487455e-01
1.412162862453531620e+00	4.661524022988805527e-02	7.645641081592429167e-01
1.412162862453531620e+00	4.303266592410559532e-02	7.471573949909404710e-01
1.412162862453531620e+00	5.350656163790545872e-02	7.444613717293399047e-01
1.412162862453531620e+00	-1.768626874770518054e-02	7.628170257054669445e-01
1.412162862453531620e+00	-6.622629307682043054e-02	7.773520107986262584e-01
1.412162862453531620e+00	-4.014262498170978466e-02	7.920733409067600705e-01
1.412162862453531620e+00	-6.568225357719453816e-02	7.457020998629556585e-01
1.412162862453531620e+00	-1.609026376729344454e-02	7.751149371152754597e-01
1.412162862453531620e+00	2.295317154720799557e-02	7.747492598248020279e-01
1.412162862453531620e+00	6.376031722393649126e-03	7.909941956397725793e-01
1.412162862453531620e+00	2.351382099783694279e-02	7.961065809662992709e-01
1.412162862453531620e+00	3.843704574909545535e-02	7.866559120074674283e-01
1.412162862453531620e+00	-6.464859896717289889e-02	8.036182168356758027e-01
1.412162862453531620e+00	-1.794247924908970448e-02	8.081201518618472690e-01
1.412162862453531620e+00	-5.810780124300807259e-03	7.971530568738484090e-01
1.412162862453531620e+00	6.954357243094200225e-02	7.769055022684988598e-01
1.412162862453531620e+00	-1.017064984564969854e-01	7.824554880988578986e-01
1.412162862453531620e+00	-8.350102960998323498e-02	8.362593904554518343e-01
1.412162862453531620e+00	4.566911539531259834e-03	8.072594883308817915e-01
1.412162862453531620e+00	5.413387191198693049e-02	8.028451402164548112e-01
1.412162862453531620e+00	-3.363031919218684163e-02	8.172977965431180714e-01
1.412162862453531620e+00	5.609469638166864058e-02	8.213911393395210148e-01
1.412162862453531620e+00	-2.531440141273488820e-05	8.221018986311969812e-01
1.412162862453531620e+00	2.890733352714658366e-02	8.162916793735064402e-01
1.412162862453531620e+00	1.367428109946566828e-02	8.256842402824738913e-01
1.412162862453531620e+00	6.527992790040748616e-02	8.120237531899365813e-01
1.412162862453531620e+00	8.275811309520231251e-02	8.173524003388126236e-01
1.412162862453531620e+00	-6.666279520318280083e-02	8.348875592872355700e-01
1.412162862453531620e+00	-2.893526413350022697e-02	8.356073528792864469e-01
1.412162862453531620e+00	3.984832503458568542e-02	8.352916624844026749e-01
1.412162862453531620e+00	-4.217461922809045971e-02	8.496592266504797708e-01
1.412162862453531620e+00	-1.707698933944146180e-02	8.542983169084829020e-01
1.412162862453531620e+00	7.057376422329841859e-03	8.467657247081311622e-01
1.412162862453531620e+00	6.093891156521358266e-02	8.333053496260416360e-01
1.412162862453531620e+00	8.709820993234851372e-02	8.389548475141229700e-01
1.412162862453531620e+00	1.118661093955054531e-01	8.237217883816955188e-01
1.412162862453531620e+00	-1.105034384545240389e-01	8.630976636029462634e-01
1.412162862453531620e+00	3.538818324000525539e-02	8.619589932401141574e-01
1.412162862453531620e+00	7.046521164524610636e-02	8.595948864037216142e-01
1.412162862453531620e+00	4.696613299337615288e-02	8.604606668474181763e-01
1.412162862453531620e+00	3.005212733788897861e-02	8.746158220610728007e-01
1.412162862453531620e+00	6.783568317515042967e-02	8.710325069488997762e-01
1.412162862453531620e+00	6.620004120950440107e-02	8.857729161863703293e-01
1.412162862453531620e+00	9.292291491057214081e-02	9.125549697657489023e-01
1.412162862453531620e+00	1.481020162348569702e-01	6.348110382983742639e-01
1.412162862453531620e+00	1.424455752261982733e-01	6.066212791884680877e-01
1.412162862453531620e+00	1.690880057596783059e-01	6.428154932649464692e-01
1.412162862453531620e+00	1.622745370195394221e-01	6.625713619655295705e-01
1.412162862453531620e+00	-1.498219835340370842e-01	6.593079269277033472e-01
1.412162862453531620e+00	-1.883532397994792107e-01	6.866572619008021183e-01
1.412162862453531620e+00	-1.567578940321404102e-01	6.267877139261706088e-01
1.412162862453531620e+00	-2.138241395105724418e-01	8.065166912716832393e-01
1.412162862453531620e+00	-1.781081654787467494e-01	7.702207673345806693e-01
1.412162862453531620e+00	-1.921234854801972536e-01	8.274723016212527371e-01
1.412162862453531620e+00	-1.285264199194119383e-01	7.934815099439480601e-01
1.412162862453531620e+00	-1.999765854635236484e-01	8.475861840192349117e-01
1.412162862453531620e+00	-1.842445751727394554e-01	8.733427766875668796e-01
1.412162862453531620e+00	-1.703888317508293060e-01	8.451627863300293919e-01
1.412162862453531620e+00	-1.843270332943550693e-01	5.325723047171149194e-01
1.412162862453531620e+00	-1.904256135941318484e-01	5.790144283395330937e-01
1.412162862453531620e+00	-2.226165077639116752e-01	5.710532268998937955e-01
1.412162862453531620e+00	-2.152468826626382503e-01	6.058261109723049875e-01
1.412162862453531620e+00	4.123395471440371995e-02	7.090122365606508215e-01
1.412162862453531620e+00	8.494227607780246991e-02	7.429733281572106218e-01
1.412162862453531620e+00	1.270534738718430701e-01	7.571202120775417654e-01
1.412162862453531620e+00	1.097247641366096982e-01	7.286944951637486234e-01
1.412162862453531620e+00	1.362953148309588025e-01	6.878820546203394670e-01
1.412162862453531620e+00	2.398485447099583112e-01	7.746641190010412625e-01
1.412162862453531620e+00	2.512662692482386939e-01	7.358960726051650969e-01
1.412162862453531620e+00	2.540675958718275895e-01	8.113559240227014024e-01
1.412162862453531620e+00	-1.550344413417204525e-01	8.851684237081723916e-01
1.412162862453531620e+00	-1.329886312036145379e-01	8.365739011790280788e-01
1.412162862453531620e+00	-1.010641905114084138e-01	8.807552657088699721e-01
1.412162862453531620e+00	-5.347029873482228579e-02	8.941326850112915059e-01
1.412162862453531620e+00	-1.720876304306334648e-02	8.798854188027067647e-01
1.412162862453531620e+00	1.436186022599514889e-01	8.869276967458833427e-01
1.412162862453531620e+00	9.303472158332526387e-02	9.372627789017258237e-01
1.412162862453531620e+00	-1.828540741655924062e-01	1.024975383677788621e+00
1.412162862453531620e+00	-1.837591394875652817e-01	1.071185348000290860e+00
1.412162862453531620e+00	-2.374062994384837921e-01	1.026516454085870667e+00
1.412162862453531620e+00	-3.821267250554272188e-02	4.992007732992443936e-01
1.412162862453531620e+00	-2.556860676265326759e-02	4.740829737694116641e-01
1.412162862453531620e+00	4.061144145779516101e-03	4.757793778795452733e-01
1.412162862453531620e+00	2.735746213717082931e-03	5.319850498997723554e-01
1.412162862453531620e+00	-1.217102772551192369e-01	5.014654245149593459e-01
1.412162862453531620e+00	-8.312288488896785177e-02	4.846966602581864181e-01
1.412162862453531620e+00	-1.083109010252423787e-01	5.203029316270426641e-01
1.412162862453531620e+00	-6.929758102274657938e-02	5.240936502605144653e-01
1.412162862453531620e+00	1.308871323271693088e-01	5.624969487939158741e-01
1.412162862453531620e+00	9.592027404905834054e-02	5.142516239419754331e-01
1.412162862453531620e+00	1.389428879374424719e-01	5.441835197644124822e-01
1.412162862453531620e+00	-2.500478089597855669e-01	6.447923604111293061e-01
1.412162862453531620e+00	-2.312809782475007125e-01	6.364129962988718248e-01
1.412162862453531620e+00	-2.094687585482883918e-01	6.266697065756163809e-01
1.412162862453531620e+00	2.861549358655698372e-01	7.055796672177989670e-01
1.412162862453531620e+00	2.430053987859536191e-01	7.004275748364656717e-01
1.412162862453531620e+00	-2.500867999855387880e-01	7.376091517209094617e-01
1.412162862453531620e+00	-2.230054934731617866e-01	7.090141876301574442e-01
1.412162862453531620e+00	-2.267540582901345081e-01	7.342082020673871279e-01
1.412162862453531620e+00	3.201258187489522955e-01	7.997304451633618916e-01
1.412162862453531620e+00	2.887296805331310834e-01	7.850124975103573988e-01
1.412162862453531620e+00	2.865636709712952035e-01	7.478760716482115711e-01
1.412162862453531620e+00	-2.355908844457180740e-01	8.193424669120480397e-01
1.412162862453531620e+00	-2.370467582424538588e-01	8.415475591381459397e-01
1.412162862453531620e+00	1.735900658763739335e-01	9.017852880087684486e-01
1.412162862453531620e+00	2.198558999786996981e-01	8.802635104005473998e-01
1.412162862453531620e+00	1.870428557481711440e-01	9.315578167747220473e-01
1.412162862453531620e+00	2.554526925883785493e-01	9.454318888841320989e-01
1.412162862453531620e+00	2.983539414916710486e-01	9.336913752468647409e-01
1.412162862453531620e+00	2.768190590661645523e-01	9.692658427341194205e-01
1.412162862453531620e+00	2.134396957692907826e-01	9.576290020945951165e-01
1.412162862453531620e+00	2.170527355843080430e-01	9.171820899220740619e-01
1.412162862453531620e+00	2.277264918770866009e-01	9.869830893650222148e-01
1.412162862453531620e+00	-6.699125420253637664e-03	1.020665143340274916e+00
1.412162862453531620e+00	-5.240181938106530657e-02	9.967776328322119905e-01
1.412162862453531620e+00	-5.779639646472878312e-03	9.689899800049222023e-01
1.412162862453531620e+00	-1.288395607428340361e-01	6.162379847471444183e-01
1.412162862453531620e+00	-1.147917176815990148e-01	6.442733657233770117e-01
1.412162862453531620e+00	-9.762543054988498392e-02	6.078958636088677148e-01
1.412162862453531620e+00	-3.988070987175779125e-02	6.334202783546261095e-01
1.412162862453531620e+00	-7.582787714466904250e-02	6.530611580800020910e-01
1.412162862453531620e+00	-1.910872651353912044e-02	6.478882144295562417e-01
1.412162862453531620e+00	1.009048613460983290e-02	6.257491570742912401e-01
1.412162862453531620e+00	8.643711147687360707e-03	6.459697605508631923e-01
1.412162862453531620e+00	-3.129117789162502161e-01	7.540803889577630814e-01
1.412162862453531620e+00	-2.873278757803296446e-01	7.460991477253497983e-01
1.412162862453531620e+00	-3.187290520238925673e-01	8.240592090753762200e-01
1.412162862453531620e+00	-2.700435975882384265e-01	8.275428639311716017e-01
1.412162862453531620e+00	-2.553636073730599088e-01	7.631393491880547053e-01
1.412162862453531620e+00	2.300824781994538215e-01	8.232239334168053313e-01
1.412162862453531620e+00	2.801371595109518609e-01	8.321927739400113433e-01
1.412162862453531620e+00	-3.016781624721312505e-01	9.264719064581700136e-01
1.412162862453531620e+00	-3.083188635504827690e-01	8.723465739763635041e-01
1.412162862453531620e+00	-2.901236969110846386e-01	8.706418649123556230e-01
1.412162862453531620e+00	-2.785150993849409562e-01	8.738410914470380320e-01
1.412162862453531620e+00	-2.235156511156281556e-01	9.191722233829321409e-01
1.412162862453531620e+00	-1.672086742498605227e-01	9.086465252221135325e-01
1.412162862453531620e+00	-9.785384216106651767e-02	9.224565164179350241e-01
1.412162862453531620e+00	-1.535779392154055234e-01	1.025265623320756658e+00
1.412162862453531620e+00	-1.690878638670166856e-01	9.779130031066477491e-01
1.412162862453531620e+00	-1.206042800576611063e-01	1.027242007342710206e+00
1.412162862453531620e+00	-9.631236812088073140e-02	1.019852583707208993e+00
1.412162862453531620e+00	-9.078135110863061463e-02	9.794170529735403141e-01
1.412162862453531620e+00	-1.241107599481825474e-01	1.100203474780971913e+00
1.412162862453531620e+00	-8.692509236665502126e-02	1.086758947398740460e+00
1.412162862453531620e+00	-9.031074820252366075e-02	1.107739166082660542e+00
1.412162862453531620e+00	-5.511630505661968549e-02	1.101535831951994560e+00
1.412162862453531620e+00	-6.854697876365029030e-02	1.056980648775430964e+00
1.412162862453531620e+00	-2.277641175716421662e-02	1.079601712943829783e+00
1.412162862453531620e+00	-2.986209875221279564e-02	1.052719194929803148e+00
1.412162862453531620e+00	1.742399254138549125e-02	1.092509655609104513e+00
1.412162862453531620e+00	-1.121896789216814128e-03	1.073233185931959710e+00
1.412162862453531620e+00	-2.397751356923058519e-01	7.793211783225028055e-01
1.412162862453531620e+00	2.556579190072826302e-01	8.401886526475232930e-01
1.412162862453531620e+00	1.346425657725722758e-01	8.605336185898463386e-01
1.412162862453531620e+00	1.577541485899429663e-01	8.661620215684112667e-01
1.412162862453531620e+00	-1.959676102740679493e-01	8.872848532117900699e-01
1.412162862453531620e+00	-1.975428154427165128e-01	9.172693007352152872e-01
1.412162862453531620e+00	5.078841763250130370e-02	9.467468455139297356e-01
1.412162862453531620e+00	3.787357207757735544e-02	1.003208615396438130e+00
1.412162862453531620e+00	1.155977020217435758e-02	9.541180251745675633e-01
1.412162862453531620e+00	-8.703693957563984895e-03	9.329918813450559512e-01
1.412162862453531620e+00	3.701340921114615323e-02	9.251341144866473964e-01
1.412162862453531620e+00	9.484705759942835268e-02	9.838835016956519741e-01
1.412162862453531620e+00	1.293742552333045914e-01	9.637346652825827809e-01
1.412162862453531620e+00	-1.379997904542260567e-01	1.077396884661905307e+00
1.412162862453531620e+00	-1.110063115958253022e-01	1.048442572978582898e+00
1.412162862453531620e+00	3.089047747978764802e-01	7.036243282681347022e-01
1.412162862453531620e+00	2.031195669053755815e-01	7.956801817239094188e-01
1.412162862453531620e+00	2.098072272866700061e-01	8.267759784981771887e-01
1.412162862453531620e+00	1.750300266928680459e-01	7.865488731273251322e-01
1.412162862453531620e+00	1.775339524923863488e-01	8.090510216560548029e-01
1.412162862453531620e+00	3.174321410244201891e-01	8.484035709191026786e-01
1.412162862453531620e+00	2.951276703596760198e-01	8.678821213751249930e-01
1.412162862453531620e+00	-9.831717738386613892e-02	5.930449974434597316e-01
1.412162862453531620e+00	-7.326647561273702536e-02	5.710632561445690980e-01
1.412162862453531620e+00	-5.506835442421914584e-02	5.908521056075601852e-01
1.412162862453531620e+00	-3.046122655812283364e-02	5.698286755830677119e-01
1.412162862453531620e+00	-4.549230229218159671e-03	5.709970740607822615e-01
1.412162862453531620e+00	8.912368214929478061e-02	1.058540236844195181e+00
1.412162862453531620e+00	4.382442986368262350e-02	1.060010223281587116e+00
1.412162862453531620e+00	1.305159307804203417e-01	1.019145084793673828e+00
1.412162862453531620e+00	1.355688538442813007e-01	1.073202828240112261e+00
1.412162862453531620e+00	1.474756000479973128e-01	1.044284745314353113e+00
1.412162862453531620e+00	1.298165803727248102e-01	1.036492637539235595e+00
1.412162862453531620e+00	5.170005172293490325e-03	1.042966390051232040e+00
1.412162862453531620e+00	-1.253103003471546240e-01	5.772690809099820797e-01
1.412162862453531620e+00	1.789750145928008518e-01	6.189382361897729501e-01
1.412162862453531620e+00	1.686695242820247520e-01	5.711187333214415851e-01
1.412162862453531620e+00	1.888229334417472760e-01	5.834384285949789639e-01
1.412162862453531620e+00	2.063443836923862795e-01	6.374319037842710589e-01
1.412162862453531620e+00	2.146114482608706409e-01	5.808471885240221733e-01
1.412162862453531620e+00	2.455035353415672139e-01	6.157324437832657482e-01
1.412162862453531620e+00	2.038146324443340651e-01	6.822500851394691646e-01
1.412162862453531620e+00	1.011246924920964352e-01	7.969693658169720862e-01
1.412162862453531620e+00	1.409506250687186935e-02	5.505803793562188408e-01
1.412162862453531620e+00	3.963439255881329171e-02	5.900703300365828241e-01
1.412162862453531620e+00	2.571057118598031321e-01	6.724057546173723976e-01
1.412162862453531620e+00	3.433827791955879061e-02	6.029693054621243498e-01
1.412162862453531620e+00	-1.661061469959761450e-01	6.003290026739186436e-01
1.412162862453531620e+00	-2.048697578444342304e-01	7.386176045212490271e-01
1.412162862453531620e+00	-1.461302921130261945e-01	7.323069940351509821e-01
1.412162862453531620e+00	-2.900051391631519593e-03	9.013144895612578145e-01
1.412162862453531620e+00	-1.502604200988819638e-01	5.586180373962119639e-01
1.412162862453531620e+00	-1.780178896659909693e-01	7.059886583941878957e-01
1.412162862453531620e+00	-2.496877211624243253e-01	7.115670701190047742e-01
1.412162862453531620e+00	-2.209394468862450056e-01	9.896323513945393113e-01
1.412162862453531620e+00	-2.602761645699736559e-01	9.987343481996504568e-01
1.412162862453531620e+00	-2.164642430968281017e-01	9.573056439583370603e-01
1.412162862453531620e+00	-1.250252057142470230e-01	9.638030325972961609e-01
1.412162862453531620e+00	-1.070152913071706902e-01	9.458913207865189410e-01
1.412162862453531620e+00	-7.205025194927244803e-02	9.563240386526641323e-01
1.412162862453531620e+00	-4.908861758876648107e-02	9.158885380297584478e-01
1.412162862453531620e+00	-4.596777149293407305e-02	9.467225709955167101e-01
1.412162862453531620e+00	1.253969442523120703e-01	9.939767075981364997e-01
1.412162862453531620e+00	1.607005885707922799e-01	1.013821962784933639e+00
1.412162862453531620e+00	1.837527846944603249e-01	1.004174421449740118e+00
1.412162862453531620e+00	-2.513174664461603758e-02	5.384474181287259853e-01
1.412162862453531620e+00	-5.475615503047431831e-02	5.399465263974829732e-01
1.412162862453531620e+00	4.159157035854510465e-02	5.484995485785589819e-01
1.412162862453531620e+00	1.429347003321501663e-01	5.148401240932480860e-01
1.412162862453531620e+00	1.096795219758083251e-01	5.716296304186222477e-01
1.412162862453531620e+00	7.374428465432703028e-02	5.213056809520615342e-01
1.412162862453531620e+00	2.178879935798107015e-01	7.187684488447072528e-01
1.412162862453531620e+00	1.854024817193979935e-01	7.319479701935593940e-01
1.412162862453531620e+00	1.640416087162107628e-01	7.499103745529593912e-01
1.412162862453531620e+00	6.246915741607517170e-02	1.099963172914847132e+00
1.412162862453531620e+00	1.548178836635133448e-01	1.078277379136882486e+00
1.412162862453531620e+00	9.649364238536206617e-02	1.102405978880692805e+00
1.412162862453531620e+00	1.887274123664869352e-01	7.080380784929336535e-01
1.412162862453531620e+00	7.767619780051659983e-02	1.011258078840349572e+00
1.412162862453531620e+00	1.807096067554802010e-01	1.033964266597729331e+00
1.412162862453531620e+00	-1.325605202844292729e-01	7.203855725643351082e-01
1.412162862453531620e+00	-3.995742168713045661e-02	6.793253236343855805e-01
1.412162862453531620e+00	-8.609743627198729321e-02	6.943845505724912659e-01
1.412162862453531620e+00	1.960432731171939391e-01	5.452451502266381089e-01
1.412162862453531620e+00	7.610159290119733466e-02	5.848300519663436337e-01
1.412162862453531620e+00	3.533843021745308732e-02	6.545083393775465996e-01
1.412162862453531620e+00	4.416677634264110086e-02	6.679795047955117138e-01
1.412162862453531620e+00	1.119605630857627432e-01	6.691669411764302744e-01
1.412162862453531620e+00	8.940755284482115872e-02	6.776804118837767010e-01
1.412162862453531620e+00	8.316247828208744863e-02	6.597670089663083548e-01
1.412162862453531620e+00	-8.402211336441373080e-02	7.733282229863732704e-01
1.412162862453531620e+00	-1.112062594616680666e-01	7.400649349568082513e-01
1.412162862453531620e+00	-1.887553545879684935e-01	6.427039975929871307e-01
1.412162862453531620e+00	3.109099773638738240e-01	8.953907137162410157e-01
1.412162862453531620e+00	2.531340210431868298e-01	8.682727131535533660e-01
1.412162862453531620e+00	1.850334600063192614e-01	8.521831997911586409e-01
1.412162862453531620e+00	2.162467918017173529e-01	1.035883206140488566e+00
1.412162862453531620e+00	-6.627251198353378836e-02	1.017783913653678374e+00
1.412162862453531620e+00	8.187679138687375957e-02	6.187474732523845500e-01
1.412162862453531620e+00	2.815263156759718610e-01	6.470731494652827154e-01
1.412162862453531620e+00	-1.821111333346253636e-01	9.311111124810880213e-01
1.412162862453531620e+00	-1.963395316552203340e-01	9.762424848043236292e-01
1.412162862453531620e+00	8.812068136546979957e-02	4.847207319723969565e-01
1.412162862453531620e+00	-1.593193571056789049e-01	9.235726611715813217e-01
1.412162862453531620e+00	-3.036118844063706579e-01	7.135900336509993780e-01
1.412162862453531620e+00	-6.358502158682821648e-02	1.051012643089823673e+00
1.412162862453531620e+00	-2.859047377891906216e-01	6.675919403115520012e-01
1.412162862453531620e+00	-1.271762616836770166e-01	9.195354041364529607e-01
